ааабк: абака кааба
аабр: араб арба раба
абирт: барит триба
абкло: балок бокал колба
аабмс: басма самба
аблмоп: апломб пломба
абмру: румба умбра
або: боа оба
абкос: басок скоба
абор: бора роба
аборту: рубато утроба
аборт: аборт борат обрат табор торба
абту: табу туба
абды: дабы дыба
аблмоь: альбом мольба
аблмооть: молотьба обломать
аавгл: влага глава
ааврт: врата трава
аавопрт: потрава правота
авде: веда дева едва
авер: вера рева
авди: вади дива
авило: виола олива
авин: вина нива
аавикпр: варикап крапива
аавкс: вакса савка саква
авкло: валок локва
авкты: выкат тыква
аавлх: валах халва хвала
авлмо: валом молва
авдено: ендова надвое
авдкооп: паводок подкова
авепрс: распев сперва
аверст: верста стерва
аверч: вчера черва
авопрр: провар прорва
авкру: курва рукав
ааавгн: гавана навага
аагклу: агулка калуга кулага
аагдно: гонада донага
аагдр: гарда драга
аагкр: карга крага
агзор: гроза розга
агзлу: загул лузга
агил: игла лига
агикн: кианг книга
агир: игра рига
агм: гам маг мга
агор: арго гора рога
агекорч: кочегар кочерга
аагкорт: каторга рогатка
агру: рагу руга угар
агклопру: полкруга прогулка
агруя: ягуар яруга
агуш: ашуг шуга
аабгортя: горбатая работяга
ад: ад да
аадирт: тирада триада
аадлру: радула рулада
ааадкнно: анаконда канонада
аабдр: барда брада
агдино: ганоид година иногда
адеезр: дереза резеда
адерс: адрес среда
адзу: зуда узда
адееинр: дарение драение нереида радение
аадилнп: паладин планида
аабдн: бадан банда
адин: анид дина инда
абдлно: блонда надолб
адноорт: ротонда торнадо
аднры: нарды рында
авдо: адов вода
авддооп: водопад подвода
адежо: жеода одежа
адко: дока кода
адмо: дома мода
адох: доха хода
аадкр: драка карда
аадепрт: адаптер петарда
адекрс: скаред скерда
адикрс: сдирка скирда
адмор: даром домра морда
абдру: будра бурда
адкопу: покуда упадок
адру: дура руда удар
адилть: ладить тильда
аажкр: жарка кража
абжо: жабо обжа
адеж: даже дежа
ажко: жако кожа
ажло: жало ложа
ажр: жар раж ржа
аабжр: баржа жабра
ажсту: стужа сутаж
аз: аз за
аабз: абаз база
аазкопр: запорка проказа
ааззр: зараз зраза
аазнф: фазан фанза
агзору: ругоза угроза
азло: зало зола лоза
азиммо: маоизм мимоза
азопр: запор проза
аавезкр: заверка каверза
азикр: кирза разик ризка
азмру: мазур мурза разум
азу: азу уза
аакр: арак арка кара рака
абккоор: барокко коробка
абдку: будка дубка
абкру: бурак бурка рубка
абкопру: парубок порубка
абкрсу: барсук бурсак срубка
абкуш: кашуб шубка
аабккуш: букашка кашубка
абкры: рыбак рыбка
аавкл: валка лавка
ааавклнп: акваплан наплавка
аавклс: свалка славка
аавкопрт: автопарк отправка
аавкрт: кварта травка
аавеклш: вешалка шалевка
авееклрт: левретка трелевка
авеклоп: полвека полевка
авдекопс: подвеска подсевка
авекопрс: вераскоп просевка
аввексы: вывеска высевка
аавиклн: ливанка наливка
аавзиклр: развилка разливка
авиклот: литовка локатив отливка
авгикр: гаврик гривка
авикопрст: спиртовка спортивка
авкко: каков ковка
авккоо: каково оковка
авккос: квасок сковка
аавиклопрс: пласировка распиловка
авкмортуш: муштровка штурмовка
авиклно: аквилон линовка
аавзиклнор: анкилозавр разлиновка
авкнос: вноска сновка
авикноорт: кротовина тонировка
авиклост: вокалист листовка
аавзкмы: вымазка замывка
ааадклн: ладанка наладка
аадкопрс: парадокс просадка распадок
аадклош: ладошка лошадка
адееклс: седелка селедка
адезкопр: подрезка проездка
адикс: адски кидас садик сидка
аадиклнр: ирландка кардинал
авдко: водка давок
абвдкоо: добавок обводка
адкло: лодка оклад
адклоос: досолка солодка
аддку: дудак дудка
абеекш: бекеша шебека
аекнш: кашне шнека
аекр: каре раек река
аекст: аскет секта сетка стека тесак теска
аекч: чаек чека
аежкл: лежак лежка лекаж
ааежклн: лежанка належка
ажкно: кожан ножка
ажкоорст: острожка сторожка
ажкопртя: отпряжка протяжка
аажкнтя: княжата натяжка
ааазкмн: мазанка намазка
аезкр: резак резка
аезкопр: позерка порезка
аезкорт: кератоз отрезка розетка
аезкру: узерка урезка
аезкт: затек тезка
аазикнн: изнанка нанизка
авзкооп: павозок повозка
аавзкня: вязанка навязка
агикло: иголка логика
аикк: каик кика
аеиклмт: метлика ткемали
авеикнор: вероника иноверка
аикнот: аконит катион тоника
ааикнр: арника иранка
адикнру: дурника ударник
агеикнортх: агротехник оргтехника
аеиикнопртх: пирокатехин пиротехника
аикп: кипа паки пика
аикопт: оптика топика
аеикмрт: керамит материк метрика
ааикстт: атаксит статика
аиикнопст: апитоксин синоптика
ааиклпст: пастилка пластика
ааикмст: аксамит мастика
ааеиикмнрст: американист арменистика
агикност: агностик гностика
ааикксту: акустика каустика
аикорстф: строфика фиксатор
аадйклмоо: малодойка молодайка
аайкл: кайла лайка
аайкм: аймак кайма майка
аейкл: лакей лейка
авеейкр: верейка еврейка
абвйкоы: баковый выбойка
айкко: какой койка
авйкопы: выпойка паковый
аккю: каюк юкка
аагкл: галка кагал
ааклм: калам малка
ааклп: лапка палка
ааклс: ласка салка скала
ааклч: калач лачка чалка
ааекклр: карелка лекарка
аеклт: летка телка
авикл: валик вилка
аиклм: малик милка
ааиклмт: каламит тамилка
аиклоп: опилка поилка
аиклп: капли липка пилка
аиклпс: клипса спилка
аиклопт: отпилка пилотка
агиклор: горилка рогалик
аиклмор: морилка рамолик
аеиклмс: ксилема месилка
аиклст: ластик стилка
ааиклнст: настилка салатник
аиклопст: литаскоп постилка скаполит
аиклсуш: силушка сушилка
азкло: закол золка
акклос: склока сколка
акклося: коляска ясколка
аклмооп: поломка помолка
аклмос: мослак сломка смолка
аклмоос: осмолка соломка
аклоп: копал полка
аклос: оскал скало солка
абклу: булка кабул
аклмя: лямка мялка
аклпя: капля пакля пялка
аакмр: карма марка рамка
аакмс: камса макса маска сакма самка
аекмн: намек немка
абикмно: обминка обнимка
акмя: маяк ямка
аабкн: бакан банка кабан
аагкн: ганка каган
ааклн: канал ланка накал
ааклнп: клапан планка
ааклну: лакуна уланка
аакнн: канна нанка
аакнр: аркан ранка
ааакнрт: таракан таранка
аадкнр: дранка кардан
ааикнрт: картина натирка тиранка
ааикннорст: иностранка санаторник
аааккнт: катанка накатка
аабикнрт: бактриан британка
аавклноч: волчанка лавчонка
аакноч: очанка чакона
авекн: венка навек
авгеклноо: велогонка головенка
аеиклнс: алексин силенка
аеклнп: наклеп паклен пленка
аекнп: пекан пенка
аекност: сонетка сотенка
аеккнотф: конфетка кофтенка
аекнсц: сканец сценка
аавикнрт: антиквар травинка
агезиклн: глазенки лезгинка
аагдикнр: градинка даргинка
адиклнь: кандиль льдинка
азиклно: анкилоз кинозал лозинка
ааиклмн: каламин малинка
аазикмнр: кармазин разминка
аикнопс: оспинка синкопа
ааикнрст: канистра старикан старинка
аееиклнпр: крапление пелеринка
аеикнпр: паникер перинка
аиккнр: краник кринка
аикнорс: росинка соринка
аикнос: косина осинка
аеиккнрт: каретник катерник кретинка
аеикност: аистенок осетинка
ааикнртт: тартинка татарник
аикност: каноист останки остинка скотина
агикнорч: горчинка органчик
аеикнпсч: пасечник песчаник песчинка
авеикнтч: ветчинка наветчик
ааикмнш: манишка машинка
ажиккнно: книжонка накожник
аиккно: иконка кокаин
аклноос: лаконос солонка
аазкноп: запонка напоказ пазанок
аакнопрт: напрокат патронка
аклну: кулан лунка
акнрсту: курсант струнка
адеклня: делянка ледянка
акностя: стоянка яснотка
ааклнтья: катальня накалять тальянка
акко: како кока
аикно: икона инока
акоп: копа опак пока
акорст: кастор костра строка торакс
аакопс: опаска пасока
адкоопс: подоска подсока
аакпц: кацап цапка
аеклп: лепка плаке
аеклпш: плешка шлепка
аекпр: капер перка репка
аекпрт: каптер паркет трепак трепка
аикпп: пикап пипка
аккоп: капок копка
ааккопрс: покраска раскопка
акопрт: прокат тропка
акопс: скопа сопка
акопт: капот покат топка
аклпшю: плюшка шлюпка
акптя: пятак пятка тяпка
аабкр: барак барка
ааавкнр: караван наварка
аавкорт: автокар отварка товарка
аабкнрту: аркбутан бунтарка
аакрст: раскат старка
аакрч: карча чарка
аекнр: анкер кенар нерка
аеикнопр: кропание пионерка
аееикннопрс: пенсионерка покраснение
аекрс: аскер серка
аекрт: актер катер терка
аеекртт: катетер тетерка
ааеккрт: актерка каретка ракетка
аеикрфц: фракиец циферка
абикопрр: приборка пробирка
адикопрт: подтирка придаток
аикрст: старик стирка
аикорстт: криостат отстирка
абкору: кобура уборка
агкор: горка кагор карго
аккоор: кокора окорка
акнор: коран крона норка оркан
аикмнор: амикрон минорка
акопр: капор копра парок порка ропак
акмоорт: мокрота моторка
ааккорст: касторка красотка
акпру: крупа пурка
авекрсух: свекруха хевсурка
акруч: круча ручка чурка
адкоруч: дочурка дурачок дурочка
адкры: дырка кадры
ааккрс: каркас краска
аакст: каста такса таска
аеклопрс: лесопарк пролеска
аекрст: стакер треска
аексст: секста стеска
аексч: секач сечка ческа
ааезксч: засечка заческа
абекосч: обсечка обческа
адекопсч: подсачек подсечка подческа
аекосч: осечка оческа
аекопрсч: просечка проческа
ааекрссч: рассечка расческа
авексчы: высечка выческа
аекпсь: пьекса пьеска
аикнсту: истукан туниска
адикопс: диаскоп дописка
аикрс: искра риска
аеикмст: акмеист метиска семитка
адкос: доска садок
акнос: аксон накос носка
акост: сотка тоска
аабгкорт: гакаборт горбатка
аабзкту: забутка зубатка
ааккотт: откатка токката
ааклмту: ламутка мулатка
ааекптч: аптечка печатка
ааекпртч: перчатка трепачка
адект: детка кадет
аеклрту: лектура рулетка
аекмт: макет метка
ааезкмт: заметка каземат
ааекнрт: катерна ранетка
аектт: катет тетка
аиклт: литка талик
аиклту: кутила улитка
аикнт: актин антик нитка
аезикнт: зенитка казинет
аикстч: считка частик чистка
аабкорт: акробат работка
аавдкот: авдотка адвокат
ааклортш: артшкола шарлотка
аакмнот: комната накатом намотка
акнот: нотка октан
аекостч: отсечка сеточка стоечка тесачок чесотка
авекрст: верстак верстка свертка
авеекрттч: четвертак четвертка
акортф: фактор фортка
аккрту: крутка куртка
аавеиклопрстт: австралопитек ватерполистка
аикорстх: акростих хористка
ааикстфш: фашистка фисташка
акорстт: стократ тростка
авекрсту: квестура уверстка
акту: акут утка
актуш: тушка штука шутка
адекстя: десятка детская
аабзку: азбука базука
акму: кума мука
авкну: внука кавун
акру: кура рука
аазкру: зарука казуар
акущ: куща щука
аабкосч: басочка собачка
ааазккч: закачка казачка
аавккчы: выкачка кавычка
аабкотч: обтачка табачок
аакоптч: потачка тапочка
аежклоч: лежачок ложечка
авдекоч: двоечка девочка
аеиклптч: петличка тепличка
аиккосч: кисочка косичка
аиклоптч: лопатчик плотичка
аикптч: птичка типчак
абкоч: бачок бочка
адеекорсч: адресочек середочка
агдкорчя: гордячка грядочка
ааклопч: лапочка палочка
ааклосч: ласочка салочка
акмоч: мачок мочка
аакморч: кочмара марочка рамочка
акмочя: маячок ямочка
акноч: кочан ночка
аекностч: станочек стеночка
акопч: копач почка
акоопртч: проточка тропочка
адкоопсч: подсачок подсочка подчасок
аазкотч: заточка зачаток
аеклоптч: платочек плеточка
авекостч: весточка качество
авкотчы: выточка отвычка
ажкуч: жучка чужак
акмуч: кумач мучка чумак
акморчя: армячок кормчая морячка
аакморш: мошкара ромашка
авекш: векша вешка
авдекош: двоешка евдошка
аекрш: краше решка
аекртш: рештак трешка
ааикнпрш: парашник парнишка
агиклнуш: гнилушка лгунишка
аикшш: шишак шишка
акмош: кошма мокша мошка
акопстуш: пастушок пустошка
аавкртуш: ватрушка травушка
авезкруш: зверушка резвушка
аеклптуш: плетушка теплушка
ааклпуш: лапушка плакуша
акопуш: копуша опушка
аакрстуш: растушка старушка
адкоучш: дочушка чадушко
ааклтшы: латышка талышка
акмшы: камыш мышка
акнопшю: капюшон понюшка
ааклть: алкать каталь лакать талька
аеклопсть: оплескать постелька
аеекнрчь: реченька черканье
аекмночь: моченька чмоканье
ааклш: шакал шкала
аалм: лама мала
аалпш: лапша палаш шпала
абвло: вобла обвал
аелмо: малое омела
аелст: стела талес
агилмо: глиома могила
аикл: кали кила
аилп: липа пали пила
аилс: лиса сила
аилф: фиал фила
авеклс: левкас свекла
акклу: кукла кулак
агдлноо: гондола надолго
аклош: лошак школа
алмос: масло смола
ааилноп: опалина пианола
алоп: опал пола
аалпт: лапта патла плата
авелт: валет ветла
аалмпу: амплуа ампула
аамр: мара рама
аадмр: дарма драма
аагмм: гамма магма
аемр: мера рема
адемр: дерма дрема
аемрст: мастер стрема
аемт: мета тема
ааемнтть: наметать тантьема
аимпр: ампир прима
аиимнт: интима тиамин
аеикллмнох: колленхима меланхолик
адеимнуц: медуница ундецима
аагмммноор: монограмма номограмма
аммсу: самум сумма
аекмот: комета текома
агмно: гнома манго
аморст: матрос строма
аимост: истома маоист
аамортх: ахромат трахома
абемр: амбре берма
агемр: гарем герма
аеелморсф: лесоферма лосеферма
аимрф: рифма фирма
аимрш: марши ширма
акмор: комар корма
амнор: норма роман
аморф: морфа форма
акморч: кормач корчма
амть: мать тьма
ан: ан на
аавиннр: нирвана равнина рванина
аанпш: панаш шпана
аелнп: пенал плена
аемн: мена наем
ааемнр: манера марена рамена
адемноп: подмена поднаем
аееемнпр: перемена перенаем
аемнот: монета немота отмена
аенп: пеан пена
аденр: дрена недра редан
аеимнрс: семинар смирена
аенст: сенат стена
аденорч: дочерна дрочена
аазкн: казан казна наказ
авезилн: вазелин левизна
адезинр: дрезина редизна
агзилно: газолин голизна
ааикнор: окарина окраина
абинрту: арбутин трибуна турбина
аавинрт: вариант травина
авдееинрсц: древесница сердцевина
аагдинр: гардина градина
адеинопр: приданое проедина
адеинрс: арсенид средина
авдееинопр: переводина продевание
азилно: анизол лозина
ааиклн: аклина калина
ааилнт: ланита талина
аеилнпр: пралине прелина
аеилнщ: лещина щелина
аилнстуу: наутилус сутулина
аимн: амин мина
адимно: динамо домина
аимня: мания ямина
аилннос: слонина соланин
аезиннр: анзерин зернина
аеиннст: нанести теснина
аабзино: анабиоз забоина
ааикнпр: арапник крапина
аеинпр: перина репина
аинпс: псина синап спина
ааинрст: нарасти санитар старина
аинру: руина урина
аикнсу: ауксин кусина
аагинорт: арагонит рогатина
адеинт: аденит детина
аеимнт: матине метина
аеинтщ: нищета тщание щетина
аилнопт: плотина полтина
аилностя: лосятина ослятина
аиноопртч: порточина проточина
аикнпуч: купчина паучник
аинш: ниша шина
аикнруш: каршуни крушина
авинощ: вонища вощина
авйно: война навой
адйно: дойна надой
авлно: волан волна
адмно: дамно домна номад
анру: руна уран урна
авенс: весна навес
аносс: насос сосна
алну: луна улан
анх: хан хна
аапр: арап пара рапа
аекпрс: каперс парсек скрепа
аекпру: каупер укрепа
агелопть: гольтепа полегать
алопт: плато толпа
аопрт: апорт тропа
аопрст: пастор стропа
аемопт: метопа помета
акпу: купа паук
апрхя: пряха хряпа
аарт: арат тара
ааикрт: китара ракита
ааорт: аорта отара
аарф: арфа фара
аарч: арча чара
абр: бар бра раб
аабмр: амбар амбра
аавлр: аврал лавра
ааагнрт: граната танагра
аеикрс: кариес секира
аилр: лира риал
аайрс: сайра сарай
аймор: майор мойра
акорс: окрас скора
анор: нора рано
аопрш: апрош шпора
аорт: рота тора
аворт: автор втора отвар рвота тавро товар
аелопрт: плетора трепало
аеилрст: реалист селитра
аимрт: мирта митра
акнорт: кантор картон контра
амру: амур муар мура
арсу: раус сура
арту: раут рута тура
аанрту: арнаут натура
аруф: фрау фура
абрсу: бурса сабур
акрсы: крыса рысак
аагнот: нагота ногата
аадт: адат дата
аалопт: лопата оплата
ааопрстт: пасторат простата
ааекрт: карета ракета
аекнотф: кенотаф конфета
ааамнрт: амарант маранта
авент: вента навет
аелнт: лента налет
аенрт: антре ранет рента
авикнт: ватник квинта
авкот: квота таков
авноорт: новатор ровнота
аиорст: аорист сирота
аиосттч: отчасти чистота
аеоптх: пехота потеха
аакрт: карат карта катар
аанрт: нарта таран
аикст: киста такси
аирстт: артист триста
аистц: асцит циста
амтуф: муфта фатум
ааптх: пахта птаха
аиптх: пахит пихта
аделть: делать дельта деталь
ау: ау уа
аагрф: аграф графа
ах: ах ха
аилосх: лосиха ослиха
аосх: соха хаос
аежрух: жеруха ухажер
аворстух: воструха ухарство
аносух: насухо носуха
авдиоц: водица двоица
аеилтц: ацетил телица
аеилптц: петлица теплица
ааиклрц: карлица лакрица
аежилрц: алжирец жерлица
абвгдееезилноорцчя: водогрязелечебница грязеводолечебница
авееинрц: веерница вереница
аазинрц: зарница разница
аимнуц: умница цунами
ааеимннстц: наместница сметанница
аадинруц: радуница ударница
авдееинрц: ведерница нерадивец
аеинрцч: арчинец черница
ааинорстц: соратница стационар
аиортц: торица троица
аееипрцч: печерица черепица
аипсц: псица спица
аирця: рация ярица
аааикнтцч: канатчица накатчица
арсцы: рысца сырца
акорч: корча рачок
аапш: апаш паша
авш: ваш вша
аикрш: рикша шарик
аапрш: парша шарап
адеикорртш: директорша кредиторша
атуш: туша ушат
абкр: барк брак краб
бек: бек кеб
бгеопр: погреб пробег
бгир: бриг гриб
бмор: бром ромб
бклоо: колоб лобок
бзноо: бозон озноб
бгор: горб гроб
бикмор: микроб ромбик
бкоор: борок короб оброк
бгер: брег герб
абзклосу: зубоскал скалозуб
бку: бук куб
абзру: арбуз заруб
бделору: ледобур ледоруб
белорсу: белорус лесоруб
брсу: брус сруб
авст: сват став
веиппр: виппер припев
вес: вес все сев
бвеос: обвес обсев
вдеопс: подвес подсев совдеп
вееепрс: перевес пересев
веипрс: привес присев
вдеенос: недовес недосев
веопрс: провес просев
веост: отвес отсев совет
ввесы: вывес высев
вди: вид див
вдеилно: винодел недолив
вилопр: прилов пролив
авимнорт: минотавр норматив
авиоптт: автотип оптатив
авинопрт: напротив провиант
взо: воз зов
ввзоы: вывоз вызов
вкос: воск сков
авклоь: альков коваль
вло: вол лов
вдикклооор: крокодилов кроликовод
виноруш: нувориш шуринов
вносы: вынос сынов
вор: вор ров
вноор: ворон норов ровно
воорст: востро остров сворот
абвеклоть: кабельтов обклевать
верс: севр серв
авдну: дуван надув
бворы: выбор обрыв
авднры: надрыв рыдван
вопры: выпор порыв
агикморф: кимограф микрофаг
абгоч: богач бочаг
гзи: зги зиг
агирстт: гастрит стратиг
агнр: гран ранг
агмнсту: мангуст мустанг
гикмнос: комингс смокинг
агилнс: салинг сигнал
гинопст: спонгит стопинг
гезлнош: лонгшез шезлонг
гдо: год дог
гйо: гой йог
гло: гол лог
агдило: галоид диалог
гделооп: логопед педолог
бгилоо: биолог облиго
агеилмоосс: осмогласие семасиолог
гилноос: лисогон синолог
гелмоорт: логометр метролог
аглоопт: логопат патолог
агглоорф: графолог логограф
вгоор: ворог говор
горт: грот торг трог
гост: гост стог
гмор: гром морг
глу: гул луг
гипсу: испуг пигус
гденру: дергун недруг
адлх: халд хлад
адр: дар рад
аадимст: адамсит амистад
авдезкноо: законовед конезавод
вдеиостх: ехидство стиховед
дек: дек кед
вдеенопр: военпред невпроед
дезопр: подрез проезд
дикс: диск скид
адиккнор: канкроид кинокадр
адзиимопрт: диатропизм призматоид
бдиор: борид обдир
вдено: девон невод
вдкоору: куровод руковод
вдкооост: водосток скотовод
дко: док код
гдлоо: голод долго
длоос: досол солод
дкмоо: домок комод
адно: анод надо
адкмоопр: макропод подрамок
дор: одр род
адзор: задор зарод
аднор: народ радон родан
агдзоор: гораздо загород
вдох: вдох вход
демоорх: мореход ходомер
доух: уход худо
вдохы: выдох выход
дкор: дрок корд
дря: ряд ярд
дену: едун неуд
бдзиллою: блюдолиз лизоблюд
для: для ляд
ввено: внове вовне
вдеор: ведро вроде древо
еж: еж же
аежкт: жакет также
аввееинорс: равновесие своенравие
авеирстц: австриец царствие
аеезимнру: неразумие разумение
авдеезинор: дозревание раздвоение
авдееинопс: подсевание совпадение
ааавеиикнррсш: раскрашивание расшаркивание
аавеииклнопр: плакирование прокаливание
авдееилнос: следование совладение
абвеиноты: бытование отбывание
аадеинрст: стерадиан страдание
аеежилн: желание лежание
адеееилнн: наделение неделание
аеиимнноп: поминание понимание
абеинорс: бросание собрание
аеиинрст: ристание стирание
ааеинтч: начатие тачание
веееилноп: повеление полевение
авдееилн: владение давление
еежилну: лужение неужели
вееилня: вяление явление
ееилнос: слоение соление
гееинно: гноение гонение
ееиннотуч: утончение уточнение
аеееикнооррстт: катеростроение ракетостроение
аееинрст: растение старение
бдееиноор: ободрение одобрение
ееинрт: терние трение
ееиноопрщ: опрощение поощрение
аееинрч: наречие рачение
еееинстч: нечестие стечение
ееинопруч: поручение упрочение
веееинопрсщ: воспрещение всепрощение просвещение
веиилня: виляние влияние
еееиопррстт: стереотипер троеперстие
веилпсты: всплытие выплести
аеипрстя: атрепсия распятие
еикп: кепи пике
веккоорт: вкоротке коверкот
еелр: леер реле
екмноос: консоме соменок
енрту: турне унтер
веос: овес свое
еинопрст: пронести спиртное
аенорт: натрое реотан
екпу: купе упек
ер: ер ре
векорс: вскоре свекор
ерту: руте туер
вдееерц: ведерце деревце
еелнооптц: отопленец полотенце
деноц: донец донце
екносуц: сукнецо суконце
еистц: истец ситец ситце
еиклш: клише лишек
ееилсщ: лесище селище
еилптущ: плутище путлище
геинощ: гноище огнище
вееиртщ: ветрище вретище
веотья: овеять ятовье
вделооопь: водополье половодье
абежоть: батожье обежать
ель: ель лье
аеелорссть: старолесье староселье
елопсь: сельпо сопель сполье
ежлуь: жулье ужель
авелноость: основатель столованье
авенрь: вранье рванье
агелнь: лганье нагель
ааекнть: катанье таканье
аавенсть: насевать сватанье
ееопрть: опереть отрепье
емсь: мсье семь
аделость: оседлать солдатье
еертть: тереть третье
ежить: ежить житье
еклооть: колотье околеть
аесстчь: счастье счесать
естуь: уесть устье
етучь: утечь чутье
есучь: сучье усечь
азииртф: физиатр фтириаз
азикпр: каприз приказ
азкоп: пазок показ
азкот: заток отказ
азл: зал лаз
азлп: залп плаз
азм: зам маз
абзор: забор образ
езлнооп: полезно полонез
езипрр: призер прирез реприз
езопр: позер порез
адзиил: диализ издали
езимр: мизер ремиз
авзно: вазон навоз
везлоос: лесовоз солевоз
взкноооп: копновоз позвонок
везнор: невроз нервоз
зоопр: позор пороз
взкмоу: вузком комвуз
бдеир: дебри дерби
адзик: задик кзади
деирс: редис среди
ажикнру: ажурник кнаружи
аиикрст: сатирик сиртаки
авиклп: плавик плавки
адзико: зодиак озадки
жикор: жирок рожки
иикопрт: киприот тропики
ииклнос: носилки силикон
иклот: колит толки
азиклноорт: золотарник разнотолки
иклуч: кулич лучик чулки
жиикмот: кожимит отжимки
икмоопрст: постромки примосток
адикнопс: подсанки посадник
авеиклн: валенки великан
иккор: кроки окрик
веикр: верки кивер
еикпс: песик пески
икнос: носик носки оникс
абеиклт: бакелит балетки
аабезиклооррст: лесоразработки солеразработки
икопрт: портик портки приток тропик
иикостч: очистки тисочки
икмост: москит мостик мостки
иксту: иктус сутки
веикосч: весочки височек
биклош: блошки лбишко
бикрю: бирюк брюки
ил: ил ли
аил: аил али
еиклн: кнели линек
агеилнт: галенит гантели
икло: кило коли
аеилнорст: антресоли орлеанист
илопс: полис сопли
аимм: амми имам
ин: ин ни
аинп: пани пиан
аинс: анис сани
авилнп: павлин плавни
зикно: козни низок
иикннш: нишкни шинник
ино: ион они
иноп: пион пони
аиккорч: кочкари очкарик
иорт: тори трио
ипр: пир при
ирт: тир три
ирф: риф фри
вееиррс: реверси ресивер
еинт: нети теин
везит: везти извет
авезинт: авизент навезти
вийот: витой войти
аирст: расти сатир ситар триас
адиопрст: пародист подрасти
аиипррст: прирасти рапирист
аеилнпст: наплести пластеин
еилопст: оплести политес
еилопстт: отплести пистолет
еимст: мести метис семит
аезимрст: астеризм размести
еимопрст: перистом промести
везиност: вознести известно
беирсту: буерист убрести
еикрст: крести рексит
деикорсст: диссектор доскрести
гисту: гусит густи
аеилнпть: налепить пенальти
аинц: наци циан
икорч: корчи чирок
еиклщ: клещи лещик
айкот: такой токай
аиймнт: минтай наймит
вейлоос: слоевой солевой соловей
вдейлоо: водолей деловой долевой
ббейлос: бейсбол бобслей
абийр: барий рабий
адийкс: адский садкий
ийкрю: кюрий юркий
абийкрс: барский рабский
веийкорстч: творческий чертовский
гдееиийклоопсч: логопедический педологический
агеиийклоопстч: логопатический патологический
дееиийкмостч: демотический методический
агезииийкорсфч: агрофизический изографический
адееииийкммнорстч: динамометрический термодинамический
ееиийкмрстч: метрический термический
геееиийкморстч: геометрический геотермический
еееиийкклморрсттчэ: термоэлектрический электрометрический электротермический
еиийкопстч: оптический топический
аееииийкнпссттч: антисептический пантеистический
аеиийкксстуч: акустический каустический
агеиийкмноорсфч: монографический номографический
аиийккрс: иракский каирский
аийкмносс: масонский османский
аеийккпрс: каперский пекарский
деиийккоррст: директорский кредиторский
аийклмсту: ламутский мулатский
аийклстшы: латышский талышский
геийклноь: голенький легонький
бдеийкнорь: бодренький добренький
еийклнсыь: кисельный лысенький
адзийн: дизайн задний
иийртт: иттрий тритий
ийрсы: рысий сирый
вийлоч: волчий ловчий
вдееиййнрш: вреднейший древнейший
абзйноор: образной разнобой
бвейоорт: бортевой ветробой
бвейлоо: беловой болевой
вейлмоо: меловой молевой
веежйнорст: стержневой стрежневой
вейлоопт: полтевой тепловой
вгйлооу: луговой угловой
вгзйооры: грызовой розговый
вийкоорс: искровой рисковой
вйкоосты: стоковый стыковой
вйкоотшы: шкотовый штыковой
вйлооты: лотовый толовый тыловой
вдймооы: домовый дымовой
вейноост: отсевной стеновой
вгйнооор: говорной горновой
вйооопст: постовой стоповой
ввейоост: вестовой световой
авйноорт: отварной рантовой
бвийноот: бинтовой отбивной
вйооорст: ростовой сортовой
бвйооты: ботовый бытовой
вйот: войт твой
еймно: йомен немой
вдейноопс: подвесной подсевной
вейноопрс: провесной просевной
авззйноы: завозный зазывной
авзйнноы: навозный назывной
взийнопры: привозный призывной
вдйноопры: подворный подрывной
вйкноопры: покровный покрывной
вйноопрры: проворный прорывной
вйноорты: воротный отрывной
дезйноопр: подрезной проездной
жйноопртя: отпряжной протяжной
ймноуч: мучной чумной
айнопр: парной рапной
ейнопщ: пещной щепной
вйнноосы: выносной основный
йот: йот той
бдезйкоруы: редкозубый узкобедрый
веейлсы: веселый селевый
веейнрчы: верченый черневый
вдееийлнопсы: велосипедный непоседливый
вийклосты: слитковый тоскливый
вийлоопрты: ропотливый торопливый
вийлопсы: плисовый сопливый
авийлопсы: опасливый сиволапый
авийклопсты: пакостливый пластиковый
вийклноучы: луковичный уклончивый
абвгйоры: багровый грабовый
бвймооры: бромовый ромбовый
бвйкоуы: буковый кубовый
вгйнотуы: вогнутый тунговый
вдеймоы: ведомый медовый
бвдейоры: бердовый бредовый
вдйкооы: доковый кодовый
бвзийорыю: бирюзовый изюбровый
авйклоы: каловый лаковый
бвйклооы: блоковый лобковый
вийкоты: китовый тиковый
авийклосты: кисловатый ластиковый
авййклоы: кайловый лайковый
вйклооты: котловый лотковый толковый
авйкопры: карповый парковый
вйкнооры: кроновый норковый
вейкорсты: крестовый тресковый
авйкостучы: сучковатый участковый
вйкоорсты: костровый ростковый
авдйнооры: радоновый родановый
авйкноры: коварный крановый
авзиийлннооры: изолированный розанилиновый
вдеийкнорсты: декстриновый крестовидный
аввийноты: ватиновый виноватый
авийносты: сановитый сатиновый
ввийнноы: винновый виновный
вдеймнооры: водомерный модерновый
вейнорты: твореный терновый
авжйноры: жанровый овражный
авйнорты: нартовый натровый отравный товарный
вейортфы: трефовый фетровый
вийосты: истовый ситовый тисовый
вйоорсты: торсовый тросовый
авезийкморты: керамзитовый маркизетовый
авийорттхы: трахитовый хитроватый
вйоосты: остовый сотовый
вйотуфы: туфовый футовый
беейллоты: белотелый облетелый
ийклнопы: клопиный пониклый
ийкллмнооосчы: кисломолочный молочнокислый
аежиймноррсты: нерасторжимый старорежимный
езиймнры: мизерный незримый ремизный
авйнры: равный рваный
аайкмносты: самокатный самотканый
аейнпрты: пернатый трепаный
айноптшы: поташный штопаный
аейнсчы: саечный чесаный
аймноты: атомный мотаный
аейнпсчы: пасечный песчаный
бдйноопры: подборный подробный
бйнортуы: отрубный утробный
аввейннорсы: равновесный своенравный
вдийны: видный дивный
вдеиийкнрты: директивный кредитивный
авйклноыь: альковный вокальный
вийклнооты: волокитный китоловный
вийнночы: овчинный чиновный
адейлнны: деланный неладный
адйнчы: дачный чадный
вдеейннры: ведренный невредный
адийнорсты: астроидный роданистый
бвдйноорыы: довыборный рыбоводный
дййноы: дойный йодный
деймнноы: доменный немодный
дйнрыя: рдяный рядный
ейлносы: слоеный соленый
ейлнопты: полетный топленый
авейнрты: ватерный тавреный
деймнруы: мудреный немудрый
дейнрыя: ядерный ядреный
еейлнчы: леечный леченый
ейкнночы: конечный конченый
еймночы: моечный моченый
ейнотчы: отечный точеный
ейкнопчы: кепочный копченый
еейнпрчы: перечный перченый
ейкноршы: кошерный крошеный
ейнтушы: тушеный утешный
адежйннопры: непродажный подержанный
аежйнты: женатый таежный
аежймнны: жеманный манежный
ежйлнносы: несложный сложенный
азийкнпры: капризный приказный
абзйноры: заборный образный
аезйнпрты: запретный трапезный
ийлносы: лосиный ослиный
гийносты: гостиный огнистый
йкмноорты: мокротный откормный
агйнноры: нагорный органный
аийлмнны: лиманный малинный
аийннптуы: паутинный упитанный
веейннры: неверный ревенный
вейкнноорсы: кровеносный сокровенный
деейлнноты: недолетный отделенный
еейллмнноопрсшыы: лесопромышленный солепромышленный
еймнноты: монетный отменный
адейннруы: неударный ударенный
аеймннры: манерный маренный
ейнносты: сонетный сотенный
аейнннсты: настенный ненастный
аейннрстшы: нестрашный страшенный
авийкнноры: киноварный раковинный
агзйнноы: газонный загонный
аеийкннорцы: акционерный реакционный
йкнносуы: конусный суконный
йнноты: нотный тонный
агйлннуы: галунный лагунный
ейннопртыя: неопрятный потерянный
йнопсты: постный стопный
аагйннры: ангарный нагарный
абгйноры: багорный богарный
аейкнпры: каперный пекарный
ааймнорты: ароматный атомарный
аейлннпры: планерный пленарный
айнрты: ратный тарный
абйнорчы: барочный бочарный
агейлнры: галерный лагерный
ейкнорсты: корсетный окрестный секторный стокерный
еиймннры: минерный немирный
авеийклнртыь: вертикальный кильватерный
аейкнрты: каретный катерный ракетный
агийннрты: гранитный тангирный
абйнорты: обратный работный таборный
йноопрты: ропотный топорный
йноопрчы: порочный чопорный
йнопруы: понурый упорный
йнорсы: росный сорный
йнорты: ротный торный
йлноопртуы: полуротный полуторный
айлнпрстыы: пластырный псалтырный
аайлнсты: атласный салатный
ейнсты: сетный тесный
безйносы: безносый безосный
аайкннты: канатный накатный
адеийклнты: деликатный диалектный
аейнптчы: аптечный печатный
еийлнпрты: перлитный прилетный
еймнсты: местный сметный
вееймннсты: внесметный невместный
ейнстчы: счетный честный
еейннстчы: несчетный нечестный
беейнсстчы: бессчетный бесчестный
ийлнстуфыь: сульфитный фистульный
йкносты: костный скотный
ейноптшы: потешный шепотный
айносттчы: статочный частотный
аейнрсты: арестный нестарый
ийностчы: очистный тисочный
ийнпртыя: принятый приятный
абйлночы: балочный облачный
абвйнноорчы: новобрачный равнобочный
аейнпрччы: прачечный чепрачный
ейнортчы: терочный троечный
ейностчы: отсечный сеточный стоечный
адийнопрсчы: присадочный спорадичный
абийлнтчы: блинчатый табличный
ийлностчы: слиточный столичный
еийлнптчы: петличный тепличный
бйлноучы: булочный лубочный
авейлночшы: вешалочный шалевочный
вийлноопчы: пиловочный поливочный
бвйноорчыы: выборочный обрывочный
деейлносчы: седелочный селедочный
аймнорчы: марочный рамочный
ймноотчы: моточный отмочный
йнооптчы: поточный топочный
йноопртчы: порточный проточный
йнстчыыя: тысячный ястычный
адйнрушы: дурашный радушный
авийлнпрыь: правильный привальный
агйлнорстыь: гастрольный строгальный
аазйклнуыь: казуальный каузальный
аейклнфыь: кафельный кефальный факельный фекальный
аийлнпщыь: пищальный щипальный
ааейклмнрыь: камеральный карамельный
аийлнртуыь: ритуальный утиральный
адейлнтыь: дательный детальный
аейлнпстыь: пастельный стапельный
веийлнрсыь: свирельный сервильный
еиийллнстчыь: сличительный числительный
бдеийлноортыь: ободрительный одобрительный
вееийлнопрсттыь: воспретительный просветительный
ейклностыь: костельный стекольный
бдийлнорыь: бродильный дробильный
ийлнопсыь: испольный посильный
гйлноуыь: огульный угольный
бдйоры: бодрый добрый
ейпрсты: пестрый спертый
вдеийлоты: деловитый ледовитый
ийкнорсты: корнистый кронистый
абкруч: барчук чурбак
авекл: валек левак
абвик: бивак вабик
адекрч: кедрач чердак
акл: кал лак
аикклш: кишлак шкалик
аккну: кукан кунак
акп: кап пак
аекпрч: чепрак черпак
акр: акр рак
акрт: карт крат трак
акрф: кафр фрак
акт: акт кат так
аикстф: истфак фактис
аклноч: колчан лончак
гекноо: некого огонек
еклос: лесок слоек
еклоопрс: пролесок проселок прослоек
аеклр: карел ларек
абекр: абрек бекар
декр: дрек кедр
еекоппр: перекоп поперек
екртш: шкерт штрек
екруч: кучер чурек
екопрс: прекос просек
ексс: секс ссек
екопрт: проект протек
екотт: октет оттек
аезкорч: разочек резачок
екклооосч: колосочек осколочек
еекночщ: нещечко щеночек
беиклноч: белочник блиночек
бикло: лобик облик
бгикор: горбик грибок гробик
вееиклт: клевеит телевик
викос: висок сивко совик
викмоост: московит мостовик
гикло: голик логик
дикнор: родник рондик
икл: кил лик
иккло: клико оклик
икклот: клотик отклик
иклор: орлик ролик
иклост: листок слиток столик
еиклрт: реликт терлик
иклос: ослик силок
иклмо: ломик милок
аббикн: бабкин бабник
викклнооп: клоповник полковник
--авгеееежииккллнннноопрр: генерал-полковник-инженер инженер-генерал-полковник
-веежиикклннноопр: инженер-полковник полковник-инженер
-вдеежиикклннноооппр: инженер-подполковник подполковник-инженер
викклноот: колоквинт толковник
виккмноор: морковкин морковник
виикнноч: овчинник чиновник
авикнорч: арчовник чаровник
диклноп: плодник полдник
дикноотх: донкихот отходник
дикнопсу: подусник посудник
еиклнч: ленчик членик
аежикнт: женатик таежник
жикноорст: острожник стрижонок
бзикноо: обнизок обозник
зикну: книзу узник
еикмнт: ментик темник
аеикмннст: наместник сметанник
ееикллмнноопрсшы: лесопромышленник солепромышленник
аикннор: аронник канонир
ааиккмннор: макаронник накомарник
аикннопрт: пантокрин патронник
биикно: бионик ибикон
аиклнопт: лапотник платоник
иикнопст: истопник синоптик
икнпсу: пискун супник
аикнопр: капонир опарник
еикнопрс: пироксен соперник
иккнру: крикун курник
еикклнос: колесник лексикон
еиклнопс: полесник поликсен
икноссу: косинус соусник
абикнт: бантик батник
ааиккннт: канатник накатник
аикнрт: рантик ратник
еиклнт: клиент летник
еикнтч: нетчик четник
биикнт: бинтик битник
аииккнрт: критикан ракитник
абикнорт: карбонит работник
икност: сотник токсин
иклностя: лосятник ослятник
дееикнрсч: сердечкин сердечник
еикмнч: мечник немчик
вдеикноч: двоечник неводчик
аеикнтчч: начетчик тачечник
аикмнорч: марочник рамочник романчик
икносч: носчик сочник
аикмнотч: маточник намотчик
веикнотцч: цветничок цветочник
аиклностч: ласточкин ласточник
икккнууш: кукушкин кукушник
аеиклнпчь: печальник чапельник
еиклнь: ельник никель
икклноось: нисколько сокольник
иклность: склонить стольник
икост: исток стоик
еикпрс: персик серпик спикер
икпрту: куприт прутик трупик
икпш: пшик шпик
ааикмрст: матрасик тамариск
икпрсу: прикус прусик
икт: кит тик
аикнртф: инфаркт франтик
бикот: биток ботик
икорт: ротик трико
дикорт: диктор дротик кордит
еикпст: пестик септик
иикстч: ситчик чистик
аикксту: акустик каустик
абдикклортууч: буртоукладчик трубоукладчик
абзикорч: заборчик образчик
ааиккнтч: канатчик накатчик
бикрущ: бурщик рубщик
веиклмощ: меловщик молевщик
авеикрстщь: скрещивать старьевщик
аеикклфщь: кафельщик факельщик
еиклопсщь: посельщик сопельщик
еклш: клеш шелк
еклщ: клещ щелк
клоп: клоп полк
акнт: кант танк
икнр: крин ринк
беежкор: бережок жеребок
бкклоу: клобук клубок
авкост: сваток ставок
векос: весок севок
вдкооот: водоток отводок
дкопру: подкур прудок
дкосу: скудо судок
азкмо: замок мазок
азкор: зарок разок
езкоорт: креозот отрезок
ккос: кокс скок
ккоосс: скосок соскок
бекло: белок кобел
еклмо: мелок млеко
еклоос: колесо оселок
еклоопс: поселок солекоп
еклот: колет котел леток телок
деклоопт: подлеток подтелок
авклноо: коновал наволок
кклооос: колосок осколок соколок
клооопт: полоток потолок
клоуч: лучок чулок
ккмоо: комок мокко
клмооот: молоток отломок
кно: кон нок
акмно: манко манок
акност: станок таксон
еклноос: лосенок осленок
икно: инок кино
икноп: пикон пинок
кноры: нырок рынок
кноопс: снопок спокон
ажкор: жарко жарок
ккооор: окорок рококо
кмоор: морок окорм
коопрс: прокос спорок
коорс: скоро сорок
корт: корт крот трок
коорт: отрок рокот роток
кору: укор урок
кноруш: коршун шнурок
акосч: косач сачок часок
ккоос: кокос косок
бкоорс: бросок собкор
кмосы: космы мысок
кот: кот кто ток
абкорт: браток брокат
еклост: костел слеток стекло
викот: виток кивот
клоот: лоток откол
кмоот: моток токмо
векорст: квестор сверток
кост: скот сток
ееклопст: лепесток телескоп
котш: кошт шкот шток
бдкоорчя: бодрячок добрячок
кош: кош шок
акпр: карп крап парк
екорч: очерк чокер
кртю: трюк тюрк
еклпс: плеск склеп
екрст: крест треск
икс: икс иск
икпс: писк скип
иксф: скиф фикс фиск
клос: лоск скол
кпсу: пуск скуп
ксу: кус сук
кту: кут тук
ксту: куст стук
дкруя: кряду рудяк
вкося: всяко свояк
костя: остяк стояк
бдкоря: бодряк добряк
авлот: автол отвал
аагдилмр: гамадрил мадригал
--аавдееежииилмннррц: вице-адмирал-инженер инженер-вице-адмирал
аглор: горал ларго
аалнтт: атлант талант тантал
ааклпт: каптал плакат
аилрту: ритуал уралит
елопрст: пострел престол
елос: осел село
еелпт: лепет петел
елот: лето отел тело
аеклорст: красотел стрекало
абиклнор: карбинол карбонил
илпс: плис слип спил
зиилортх: хризолит хризотил
блмооот: мотобол обмолот
белост: сетбол стебло
еклор: колер креол
клоос: колос сокол
лмо: лом мол
блмоо: облом обмол
еелмопр: перелом перемол
азлмор: разлом размол
лмооп: полом помол
лмоос: мосол осмол
влмоы: вылом вымол
аелмнот: метанол налетом
алнотэ: эталон этанол
алорсф: сафлор сафрол
лоопс: ослоп посол сопло
лот: лот тол
елмот: летом метол омлет
алоопст: апостол салотоп
аглну: галун лагун нагул
длоу: долу дуло одул
лопух: лопух похул
ля: ля ял
аезмс: замес сезам
амрс: марс рамс срам
амрш: марш шарм шрам
амт: мат там
амх: мах хам
агимнст: гимнаст нистагм
вдемоо: ведомо водоем
веморт: втроем мертво
емря: меря ярем
аезмт: замет затем
емотт: мотет тотем
емч: меч чем
еимнопч: нипочем чемпион
езиммноот: монотеизм неотомизм
аилмн: лиман налим
аимнно: амнион аноним
имноопт: монотип топоним
аимнст: самнит сантим
мо: мо ом
азмор: замор разом
бкмоо: боком обком
веекморч: вечерком времечко
азлмо: залом мазло
бимно: бином обмин
мор: мор ром
морту: тумор утром
мот: мот том
имопрт: импорт притом
моопт: оптом потом
имортх: трихом хромит
декмноор: комендор недокорм
имрт: мирт ритм
му: му ум
аавнс: аванс саван
аагнт: агнат таган
агииннрт: интриган нитрагин
агнор: аргон онагр орган
агноопррф: порнограф профорган
агкнру: гаркун курган
ааамнт: аманат атаман
азмно: знамо зоман
амнос: масон осман
аавнр: авран варан навар
аинрт: ратин тиран
аабнт: батан набат
аемнт: метан намет
-ааеежиикнннпрт: инженер-капитан капитан-инженер
анст: наст стан
абнту: банту бутан табун
вено: вено овен
аекмнор: камерон марокен
еилнс: селин силен
беилнту: бетулин бутилен
елнч: ленч челн член
демно: демон домен
денр: дерн дрен
екнр: керн крен
енрт: терн трен
аекнрт: катрен нектар танкер
енф: неф фен
вино: вино воин овин
винт: винт твин
иилнопс: ипсилон исполин
аиннопс: пансион сапонин
геинор: героин регион
инопст: пистон стопин
инпсу: писун супин
аеинрст: сатинер стеарин
еимнр: мерин минер
аеимнрт: материн минарет
аеилнпсь: апельсин спаниель
аеикнрт: анкерит кератин креатин
аимнортх: хиромант хроматин
ааимнортх: ахроматин махинатор
но: но он
агзно: газон загон
дно: дно дон
дкноор: кондор кордон
езмно: земно мезон
езнор: зерно резон
икноопрс: риноскоп скорпион
адкнор: дакрон дракон
клноо: колон локон
илно: илон лино
клноу: клоун колун кулон лукно уклон
лнооп: полно полон
гмноо: гомон много
кнопу: копун купно купон
абнор: барон набор
имнор: минор мирон
кнор: корн крон
ееклмнооррттэ: термоэлектрон электромонтер
нору: орун руно урон
нос: нос сон
инносу: нониус унисон
екнот: кетон некто
екнорт: корнет кретон ректон
лноопту: лопотун полутон
иклнооть: котильон ниотколь
кнорту: контур котурн
аклнпу: каплун плакун
екнрсту: стрекун трескун
клноту: колтун толкун
нту: нут тун унт
винссту: свинтус свистун
абня: баня баян
било: било либо
авопр: вапор повар право
веорч: вечор чрево
влоос: волос слово
абворст: барство рабство
ввиклооостт: волокитство китоловство
ввдкооорсту: куроводство руководство
вдежорсту: дежурство дружество
бвезноостья: обезьянство светобоязнь
авеклорст: лекарство стекловар
веилоссттья: осветлиться сиятельство
гемноопр: многопер премного
агмор: марго могар
декор: декор докер кредо
адлно: ладно ландо
дноор: донор рондо
бдеор: бедро бердо
бдоор: бордо добор добро
аиклоптшь: пальтишко платьишко
клооть: колоть локоть отколь только
клоость: сколоть столько
блотя: тябло ялбот
елоч: лечо чело
веилост: велосит светило
елопрт: пролет трепло
елопт: полет тепло
еелморс: ремесло солемер
лопту: отлуп путло
лопя: опля пяло
илмотуь: ультимо умолить
белмоь: бельмо бемоль
авднооп: повадно подавно
авеннор: наверно неравно
дноря: родня рядно
кносу: конус сукно
аезмнот: заметно затемно
еност: сонет тесно
инопрс: принос присно
нося: соня ясно
оп: оп по
доря: дояр ядро
еопртя: потеря пятеро
иорст: ситро сорит
биорст: бистро сорбит
орту: утор утро
оопрс: опрос порос просо сопор
от: от то
азот: азот зато
оопрт: отпор порто ропот топор
ост: ост сот сто
еопрст: престо протес
оопрст: просто стопор
опту: путо утоп
алопть: лапоть лопать пальто поталь
лоопх: плохо холоп
беорц: берцо борец
клооць: кольцо цоколь
апрх: прах храп
апс: пас сап
апх: пах хап
аелпрт: прелат талреп
епсц: спец сцеп
екмоопрст: компостер термоскоп
опрт: порт троп
аалнопртт: атлантроп плантатор
опрст: спорт строп
опт: опт пот топ
емопт: метоп помет
жиоопрт: жиропот жиротоп
опст: пост стоп
епрс: перс репс серп
епрш: перш шерп
прту: прут тпру труп
прсту: спрут спурт струп
допсту: доступ подуст
лпхю: плюх хлюп
лпшю: плюш шлюп
аагнр: ангар нагар
аддеморр: дромадер дромедар
адинр: динар надир
агрсу: аргус гарус гусар
аемноррту: нумератор ремонтуар
веерс: верес север
вееррс: реверс сервер
аезмр: замер мазер
еиккрт: крикет тиккер
екопр: копер покер
екорст: корсет костер окрест сектор стокер
аабелрт: арбалет баталер
еимрст: мистер стимер
еимопррст: спирометр спиртомер
-аеежиймннорр: инженер-майор майор-инженер
--аагеееежийлмннноррр: генерал-майор-инженер инженер-генерал-майор
аеиннорстц: иностранец станционер
аепрт: патер тапер
авеиклрть: вертикаль кильватер
аекррт: картер кратер
еилрт: литер релит
ееипррт: репетир репитер
веинрт: винтер неврит
емнорт: ментор монтер ремонт
еопррт: портер претор репорт
еимопррт: импортер пирометр реимпорт
екопррстэ: реэкспорт экспортер
аекнрст: кнастер накрест
еерстт: сеттер тестер
еирфш: шериф шифер
аекнрц: канцер кранец
аавеклрь: акварель кавальер
агинрт: гранит тангир
аикрф: факир фиакр
аипрт: пират тапир
боорт: отбор робот
орс: орс сор
орт: орт рот тор
деикоррт: директор кредитор
иклорт: клитор ликтор
векорт: вектор корвет
оопррст: пророст простор
ортф: торф форт фтор
аиортт: аортит отиатр
анрт: натр рант
аеимнрстт: мартенсит сантиметр
еимопртт: оптиметр типометр
авеелмммоопрртть: ампервольтомметр вольтамперомметр
елмопрстуь: полусмерть пульсометр
авеелммопрртть: ампервольтметр вольтамперметр
ертф: треф ферт фетр
акррсу: ракурс раскур
версух: сверху хевсур
алмря: маляр марля
аабкрс: баркас карбас
аборст: собрат торбас
аглс: галс глас
аалст: атлас салат
апсс: пасс спас
абрс: барс брас
аамрст: матрас сармат
аксту: кутас скаут
ест: сет тес
есту: туес утес
аггеийннорст: гнейсогранит гранитогнейс
ееклст: скелет телекс
аннос: анонс нанос
глоос: голос логос
орст: рост сорт торс трос
иклорст: кролист ликтрос
апрс: парс рапс
су: су ус
асуч: усач чаус
копрсу: корпус прокус
рсту: руст трус
абеилтц: балтиец целибат
агеенрт: реагент ренегат
аакнт: акант канат накат
ааиклпстт: плакатист пластикат
алмту: ламут мулат
аадимт: адамит диамат
аимстт: истмат мастит
аагнрт: гарант гранат
аптш: пшат шпат
агрт: гарт грат
авеилрт: алеврит левират
аекннорттц: концентрат концертант
бекрту: беркут курбет
веелоссть: веселость сельсовет
вест: вест свет
аезикмрт: керамзит маркизет
еилпрт: перлит прилет
беинотт: бетонит бонитет
еотц: отец оцет
биклтуь: клубить кульбит
агеимнтт: антегмит магнетит
еимртт: метрит термит
аиикнт: каинит кианит
аиилнстт: латинист сталинит
еинрттэ: энтерит этернит
аеилрстф: сфалерит фалерист
иипрт: иприт пирит
иортт: ортит торит
аиопртт: паротит патриот
икмоортф: кормофит микотроф
еекпртф: перфект префект
ортт: торт трот
вемооссть: весомость восемьсот
еепртц: рецепт трепец
деилмост: мелодист моделист
аавеиклрст: акварелист кавалерист
агимнорст: гармонист морганист
абиилностт: биатлонист линобатист
аилстть: альтист листать
ату: ату аут
туф: туф фут
туш: туш шут
алть: альт таль
еклть: кельт клеть
уф: уф фу
арфш: фарш шарф
елфшь: флешь шельф
амнорх: монарх номарх
веилносц: словинец сонливец
вдеорц: дворец дровец
агенц: агнец ганец
еенсця: сеянец ясенец
вееенопрсцщ: всепрощенец просвещенец
ептуц: путец тупец
аврч: врач рвач
икмшя: кишмя мякиш
алтшы: латыш талыш
аврты: тавры травы
-гинноруфы: угро-финны финно-угры
боры: боры обры
бзья: бязь зябь
вноь: вонь новь
денсь: днесь снедь
диорть: родить триодь
взитья: витязь язвить
агелрь: лагерь регаль
аглорсть: гастроль строгаль
аилнфь: фалинь финаль
алсть: слать сталь
алстуь: услать усталь
аеклфь: кафель кефаль
делпуь: дупель пудель
аеклрь: келарь лекарь ракель
елмоть: мотель отмель
аелпсть: пастель стапель
аелптшь: шлепать шпатель штапель
еелоптть: оттепель полететь
аелрть: артель тарель
елопсть: постель топсель
авдееллость: следователь совладетель
агелртуь: ругатель утлегарь
адезилость: созидатель соиздатель
аделопть: податель поделать
беелть: белеть бетель
еелмть: мелеть метель
беилоть: обелить обитель
авеилортть: литеровать отравитель
веиллоть: лиловеть ловитель
еиклть: китель клеить
аеиклнть: канитель наклеить
вееилопрть: переловить поверитель
еиклорстуь: куролесить ускоритель
аеиклрсть: краситель расклеить
деилноопсть: подноситель посолиднеть
деилноость: доноситель недосолить
авеилорстть: селитровать совратитель
вееилопрстть: просветитель терпеливость
агелнть: гантель наглеть
веиилрссть: иссверлить свиристель
ееилнпртья: неприятель перелинять
гдилрья: грядиль дрягиль
илсть: слить стиль
еиилпрсть: перистиль приселить
еиклстть: стеклить текстиль
аилность: наслоить насолить станиоль
лоопть: полоть тополь
алопрь: лопарь пароль
лось: лось соль
агилнорть: горланить гранитоль
илопсть: пистоль сплоить
лнуь: лунь нуль
емстуь: суметь сутемь
дезнуь: зудень уздень
еежнрсть: стержень стрежень
еемнть: неметь темень
еелнпсь: плесень слепень
нпстуыь: пустынь сыпнуть
епсть: спеть степь
ооопрть: опороть оторопь
ееппрстуь: переступь преуспеть
аврть: врать рвать тварь
авртуь: урвать утварь
аекрсь: кесарь секарь
акрстуь: кустарь украсть
еепрть: переть теперь
аилпрсть: прислать псалтирь
рсыь: рысь сырь
абгортыь: богатырь обыграть
алпрстыь: пластырь псалтырь
еопсть: поесть потесь сопеть
еинопссть: понестись стенопись
веиопссть: повестись светопись
еилопсть: летопись ослепить поселить
аипссть: пастись списать
веиссть: вестись свесить
иорссттья: отрястись строиться
иопрссттья: потрястись проститься
ирссттуья: струиться труситься утрястись
абеклоть: колебать облекать
абгдеорть: догребать обдергать
абгеопрть: погребать пробегать
абгеортть: горбатеть отгребать
абекорстть: обстрекать отскребать
аабгзирть: забагрить заграбить разгибать
абгиопрть: пограбить прогибать
абгиотть: богатить отгибать
абдоопть: пободать подобать
абртуь: рубать убрать
аабзрртуь: разрубать разубрать
абзиртуь: забурить зарубить изрубать изубрать
абипрртуь: прирубать приубрать
аавдзить: задавить издавать
аавдопрть: оправдать продавать
аавзнть: знавать назвать
аавзность: засновать сознавать
аавстть: сватать ставать
ааавзстть: засватать заставать
аабвостть: бастовать обставать
аавеепрстть: пересватать переставать
аавипрстть: присватать приставать
аввеоть: воевать овевать
аввесть: всевать свевать
авдеть: ведать девать
аавдезрть: разведать раздевать
авдеопть: допевать поведать подевать
авдеопрть: допревать проведать продевать
аавежзрть: заржаветь разжевать
авежзить: езживать изжевать
авежопрть: поржаветь прожевать
аавезилмть: замеливать измалевать
аавезклть: завлекать заклевать
аавеклнть: навлекать наклевать
авеиклсть: исклевать склеивать
авеклотть: отвлекать отклевать
авелопть: оплевать полевать
авдеопсть: доспевать подсевать
авгеорть: горевать огревать
авгеоортть: отгоревать отогревать
аввезртыь: врезывать вызревать
авдеооппрть: подопревать проповедать
авеопрсть: просевать сопревать
аавезрстть: заверстать застревать
авверстть: вверстать встревать
авеостть: отсевать сетовать
аввзтыь: взывать вызвать
ааавдзирть: задаривать задраивать раздаивать
аавдиотть: дотаивать отдаивать
аавилопть: опаливать полаивать
ааавилнсть: насаливать наслаивать
аавдилопсть: подсаливать подслаивать
аавееилпрсть: пересаливать переслаивать
аавилопрсть: пласировать просаливать прослаивать
ааавзимрть: замаривать размаивать
ааавгиннть: наганивать нагнаивать
ааавдинрть: надаривать надраивать
аавдиопррть: драпировать продраивать
аавдиортть: датировать отдаривать отдраивать
аавикортть: актировать откраивать
аавиопртть: отпаривать протаивать
абвить: бивать вабить
аабвзить: забавить забивать
аабвзиопть: позабавить позабивать
аабвинть: набавить набивать
аабвдинть: надбавить надбивать
абвдиопть: подбавить подбивать
аабвзирть: забривать разбавить разбивать
абвзиить: избавить избивать
абвиипрть: прибавить прибивать
абвииоппрть: поприбавить поприбивать
абвдиоть: добавить добивать
абвиопть: обпивать побивать
абвисть: сбавить сбивать
абвиопсть: посбавить посбивать
абвиотть: отбавить отбивать
абвитуь: убавить убивать
абвиоптуь: поубавить поубивать
авгдиопртыь: допрыгивать подрыгивать
авдеиопсть: исповедать подсеивать
аавжзиилть: зажиливать изжаливать излаживать
ааавгжинорть: ангажировать нагораживать
аввежзитыь: выезживать изжевывать
авжзиить: заживить изживать
авжииопсть: живописать посиживать
ааавзикртшь: закрашивать зашаркивать
аабвикортшь: обкрашивать обшаркивать
аавдикопртшь: подкрашивать подшаркивать
аавиикпрртшь: прикрашивать пришаркивать
аавикопртшь: пошаркивать прокашивать
аавиикрстшь: искрашивать исшаркивать
ааввикртшыь: выкрашивать вышаркивать
аабвиклость: обласкивать оскабливать
авикоппрстыь: попрыскивать поскрипывать
ааввдилопть: подавливать подваливать
аавзилть: завалить заливать
аавиклопрть: плакировать прокаливать
ааавзилмсть: замасливать засмаливать
ааавилмнсть: намасливать насмаливать
аавдилмопсть: подмасливать подсмаливать
аавееилмпрсть: перемасливать пересмаливать
аавилмопрсть: промасливать просмаливать
аавилнть: навалить наливать
аавиилпрсть: присаливать распиливать
аавдилоптчь: доплачивать подчаливать
ааавзилмортчь: размолачивать размочаливать
аавзиилмотчь: измолачивать измочаливать
абвилоть: обвалить обливать
аввилть: ввалить вливать
авгдилоптуь: подгуливать подугливать
авдилопть: подвалить подливать
авееилпрть: перевалить переливать
аавзилрть: развалить разливать
авиилпрть: привалить приливать
авилопть: оплавить повалить поливать
авилопрть: провалить проливать
авилсть: свалить славить сливать
авилотть: отвалить отливать
аввилтыь: вывалить выливать
авилпстья: плавиться спяливать
аавииннтчь: наивничать начинивать
авинопрстья: понравиться прояснивать
авдиопть: допивать повадить повидать подавить
авиоппрть: поправить пропивать
авипсть: вписать спивать
аавипрсть: распивать спаривать
ааввгиоопррть: погравировать проговаривать
ааавинпртшь: напрашивать нашпаривать
аавиопртшь: опрашивать ошпаривать
ааввипртшыь: выпрашивать вышпаривать
абвиорть: обварить обривать
авеимопррть: премировать промеривать
аабвзирртуь: разбуравить разбуривать
абвиопрртуь: пробуравить пробуривать
абввиртуыь: выбуравить выбуривать
абвдиортуь: будировать обдуривать
аавдикоптчь: докапчивать подкачивать
аабвиклоотчь: обколачивать облокачивать
аавиклооптчь: околпачивать поколачивать
авеилоптчь: повеличать полечивать
авиопртучь: проучивать упрочивать
авикопртучь: покручивать прокучивать
авиипртшь: паршивить пришивать
абввеорттыь: вытребовать обвертывать
аабвворстть: барствовать рабствовать
авгоорстть: восторгать сторговать
аавдорть: даровать радовать
авделость: следовать совладеть
авдоортуь: орудовать уродовать
авкоотть: отковать токовать
авдикость: дисковать доквасить
авморттушь: муштровать штурмовать
авилноть: линовать наловить
авноорстть: сторновать товарность
аавгдиоррть: градировать драгировать
аавеезинорстть: анестезировать заинтересовать
авгииморрть: гримировать мигрировать
аавинорсть: нарисовать санировать
авдииноорссть: диссонировать индоссировать
авиноортть: наворотить тонировать
авиопрть: оправить пировать поварить
ааввеиорррстть: реставрировать траверсировать
аавикорстть: сактировать таксировать
авиортть: отварить отравить тировать
аавиииоррттфць: ратифицировать тарифицировать
аввоорсть: ворсовать своровать
авинортть: натворить нитровать
авиорттть: отвратить титровать
аавоопстть: отпасовать потасовать
аавосстть: сосватать стасовать
авиопрстть: проставить спиртовать
абвоттыь: бытовать отбывать
аавнрть: наврать нарвать
авеепррть: переврать перервать
авдоопрть: подоврать подорвать
авопрть: поврать порвать
авопррть: проврать прорвать
аворсть: соврать сорвать
аввртыь: врывать вырвать
ааввоопсттыь: отпасовывать потасовывать
ааавдклнтыь: надкалывать накладывать
аввдитыь: видывать выдавить
аавзкстыь: высказать сказывать
аввзстыья: вызваться связывать
ааавлмнтыь: наламывать намалывать
аабвлмотыь: обламывать обмалывать
аавдлмоптыь: подламывать подмалывать
аавеелмпртыь: переламывать перемалывать
ааавзлмртыь: разламывать размалывать
аавзилмтыь: изламывать измалывать
аавдлмотыь: доламывать домалывать
аавлмопртыь: проламывать промалывать
аавлмстыь: сламывать смалывать
аавлмоттыь: отламывать отмалывать
ааввлмтыыь: выламывать вымалывать
авделтыь: выделать делывать
аавзмтыь: вымазать замывать
авмоттыь: вымотать отмывать
аавдмнтуыь: навыдумать надумывать
авзинтыь: вынизать изнывать
аавкоппртыь: покрапывать прокапывать
аавкопттыь: откапывать покатывать
авеклпстыь: выплескать склепывать
авеипрсттыь: истрепывать притесывать
авлоопттхыь: выхлопотать отхлопывать
авиоппрттыь: притопывать пропитывать
авопттуыь: опутывать утопывать
авеипрстчыь: исчерпывать причесывать
авгиртыь: выиграть игрывать
авдопртыь: повыдрать подрывать
авзиртыь: выразить изрывать
авкрстыь: выкрасть скрывать
аавипрсстыь: присасывать расписывать
авипстыь: выписать писывать
аавксттыь: вытаскать скатывать
авиттчыь: вычитать читывать
ависттчыь: высчитать считывать
аавопрсттыь: опрастывать повырастать
авопрсттыь: выпростать простывать
авпсттуыь: выступать спутывать
ааагзтшь: загашать зашагать
аагипртшь: пригашать пришагать
аагоптшь: погашать пошагать
абгеотть: богатеть отбегать
агделопть: погалдеть подлегать
абгзортыь: обгрызать обрызгать
аагдзнртыь: надгрызать надрызгать
абгиорстть: обстригать сгорбатить
агиорстть: исторгать остригать
агиопррстть: пристрогать простригать
агиорсстть: исстрогать состригать
агисть: гасить сигать
аагоррстть: расторгать растрогать
абгоорстть: горбатость обстрогать
агорсттуь: остругать устрогать
агдопртыь: допрыгать подрыгать подыграть
агопрттья: отпрягать протягать
аадинпсть: надписать ниспадать
аадопрстть: подрастать пострадать
абдоть: бодать обдать
авдезить: завидеть изведать
аденсть: саднеть снедать
адеопрть: порадеть проедать
ааджость: досажать осаждать
абдежопть: побеждать подбежать
аджопть: поджать пождать
аджорть: дожрать дрожать рождать
ааджзорть: задрожать зарождать
авджзоорть: вздорожать возрождать
аджоопрть: подрожать порождать
аадзрть: задрать раздать
авдить: видать давить
авдееипрть: перевидать передавить
авдитуь: увидать удавить
адикть: кадить кидать
адикопть: докипать покадить покидать
адикотть: докатить откидать
абдоопрть: подобрать прободать
агдлооть: голодать оглодать
адопрть: подрать продать
аддоопрть: допродать пододрать
аабжзиорть: изображать разобижать
аажстуь: ужасать усажать
аежлть: жалеть желать лежать
авежзлоть: возжелать возлежать
аежлопть: пожалеть пожелать полежать
адежопрть: подержать подрежать
аажзрть: заржать разжать
аажзинть: зажинать занижать
ажинопть: пожинать понижать
ажинсть: сжинать снижать
ажинтуь: ужинать унижать
ажопрть: пожрать поржать прожать
ажрть: жрать ржать
ажопррть: прожрать проржать
аажнрстья: нажраться снаряжать
аазкопть: закопать показать
ааззилть: залазить зализать излазать
аазлсть: заслать слазать
аазмотть: замотать отмазать
абезлоть: заболеть облезать
аезилпрть: прилезать разлепить
аезрть: ерзать резать
ааеззрть: заерзать зарезать
абезорть: заробеть обрезать
аезипррть: презирать прирезать
адезорть: дорезать разодеть
аезопрть: поерзать порезать
аезопррть: прорезать разопреть
азилть: залить лазить лизать
абзилоть: облазить облизать
аеезилпрть: перелазить перелизать
аззиилть: излазить излизать
азилопть: полазить полизать
азилопрть: пролазить пролизать
азилсть: слазить слизать
азилотть: отлазить отлизать
аззиинть: занизить изнизать
азнопрть: прознать пронзать
адезрть: дерзать зардеть раздеть
авззитья: завязить извязать
авзстья: зваться связать
ааклопть: оплакать полакать
аактть: катать такать
аакоптть: откапать покатать потакать
аавктчь: вкачать чавкать
аекоппрть: попрекать пропекать
аекрстть: скатерть стрекать трескать
аикнопть: накопить поникать
аиксть: искать сикать
аиктть: катить тикать
аекртчь: картечь черкать
аикртчь: кричать чиркать
аазикртчь: закричать зачиркать
ааикнртчь: накричать начиркать
аееикпрртчь: перекричать перечиркать
аикопртчь: покричать почиркать
акморсть: кромсать маркость сморкать
авкморстыь: выкромсать высморкать
аазкортть: заторкать разоткать
аеклпсть: плескать склепать
аееикпрсть: переискать перекисать
аикопсть: ископать поискать
аикопрсть: покрасить проискать прокисать
аикстть: исткать скатить тискать
авикстть: вскатить втискать сквитать
аикопстть: пакостить потискать
авикстыь: выискать выкисать
акопрсть: покрасть порскать скропать
акпстуь: пускать скупать
акопстуь: опускать покусать
акопсттуь: отпускать постукать
акопрстыь: опрыскать порыскать
акттуь: кутать тукать уткать
авкттыь: втыкать выткать
акнтуь: кануть нукать
акноптуь: копануть понукать
аакттуь: атукать укатать
акмтуья: мяукать умякать
аделсть: сделать седлать
абделоть: обалдеть обделать
авделть: вделать владеть
аделотть: долетать отделать
аазилстть: заластить застилать
аееилпрстть: перелистать перестилать
аилопстть: полистать постилать
аилопрстть: пролистать простилать
аилсттуь: уластить устилать
аилопсть: исполать посалить
алопсть: лопасть послать слопать
аилпрстыь: присылать распылить
аазимнть: заманить заминать занимать
аазимнопть: запоминать позанимать
ааимннть: наминать нанимать
ааиимннпрть: напринимать принанимать
абимноть: обминать обнимать
авимнть: вминать внимать
адимнопть: подманить подминать поднимать
аееимнпрть: переманить переминать перенимать
аазимнрть: разманить разминать разнимать
аиимнпрть: приманить приминать принимать
адимноть: доминать донимать
аимнопть: поманить поминать понимать
аимнопрть: проминать пронимать
аимнсть: сманить сминать снимать
аимнотть: отманить отминать отнимать
аимнтуь: уманить уминать унимать
авимнтыь: выманить выминать вынимать
азилмоть: заломить замолить изломать
алмость: малость сломать
агзинть: загнить изгнать
абжиноть: обжинать обнажить
аинпть: напить пинать
аакоппрть: покрапать прокапать
ааптхь: пахать хапать
ааазптхь: запахать захапать
ааанптхь: напахать нахапать
аапстхь: спахать схапать
аеипрстть: истрепать притесать
аикоптть: откипать покатить
аазилпть: залипать запалить
абилопть: облапить облипать
авилпть: влипать плавить
адилоппть: подлипать подпалить
аиилппрть: прилипать припалить
аилпсть: слипать спалить
аилоптть: лопатить оплатить отлипать
аиптщь: пищать щипать
аазиптщь: запищать защипать
адиоптщь: дощипать пощадить
аиопттщь: отщипать потащить
акопсть: пакость скопать
алоопттхь: отхлопать хлопотать
аооппртть: пороптать протопать
аоопттть: отоптать оттопать топотать
аопттуь: опутать утопать
аеипрстчь: исчерпать причесать
апсть: пасть спать
аазпсть: запасть заспать
аанпсть: напасть наспать
аееппрсть: перепасть переспать
аиппрсть: припасть приспать
аоппсть: попасть поспать
аоппрсть: пропасть проспать
апсттуь: спутать ступать
авпстыь: всыпать выпасть
алптхью: плюхать хлюпать
алпстья: плясать сляпать
апрсттья: спрятать стряпать
аазимрть: замирать измарать
абзирть: забрить избрать разбить
абдзиорть: доизбрать забродить задобрить
аборсть: бросать собрать
абоортть: обротать отобрать
агдиорть: доиграть оградить
агиопррть: пригорать проиграть
адзиорть: зародить изодрать раздоить
адорсть: радость содрать
аабзирть: базарить забирать
абдиорть: добирать обдирать
абиортть: обратить обтирать отбирать
авдиопрть: подварить подвирать продавить
авееипррть: переварить перевирать
авиипррть: приварить привирать
аадзирть: задарить задирать задраить
аадинрть: надарить надирать надраить
адееипррть: передарить передирать
аадзиррть: раздарить раздирать
адиопрть: допарить подарить подирать
адиопррть: продирать продраить
адиортть: дотирать отдарить отдирать отдраить
адиртуь: ударить удирать
авдиртыь: выдирать выдраить
аажинрть: нажарить нажирать
абжиорть: обжарить обжирать
аеежипррть: пережарить пережирать
аджиорть: дожарить дожирать
ажиопрть: пожарить пожирать
ажиопррть: прожарить прожирать
ажирсть: сжарить сжирать
авжиртыь: выжарить выжирать
авзирть: взирать развить
азиорть: озарить озирать
абиморть: обмирать обрамить
аазипрть: запарить запирать
ааинпрть: напарить напирать
авипрть: впирать править
аееиппррть: перепарить перепирать
аииппррть: припарить припирать
аиоппрть: попарить попирать
аиоппррть: пропарить пропирать
аипрсть: распить спарить спирать
ааипррсть: распарить распирать
аиопртть: отпарить отпирать потирать
аипртуь: упарить упирать
авипртыь: выпарить выпирать
ааинртть: натирать таранить
авиртть: втирать таврить травить
аирстть: растить ристать старить стирать
аазирстть: зарастить застирать
ааинрстть: нарастить настирать
адиорстть: дорастить достирать
аиопрстть: порастить постирать растопить
аиопррстть: прорастить простирать
аиорсстть: состарить состирать
аиорсттть: отрастить отстирать
авирсттыь: вырастить выстирать
ааенстть: натесать сатанеть
аеопрстть: постареть протесать
аеопрстчь: посерчать прочесать
аеосттчь: отчесать сочетать
авиопрсть: воспарить провисать
авиостть: оставить отвисать
авикссть: вскисать сквасить
адиопсть: дописать посадить
аделоптть: доплетать подлетать
аелоптть: оплетать полетать
авиопстть: воспитать поставить
аиопрттчь: портачить прочитать
аисттчь: считать частить
аазисттчь: засчитать зачастить
аиипрсттчь: присчитать причастить
аисттучь: усчитать участить
ааборстть: обрастать сработать
акоортть: коротать рокотать
азимотть: затомить измотать
агоорттхь: грохотать отгрохать
аоптттуь: отпутать утоптать
авиосстть: освистать составить
ааоптхь: опахать поахать
аепртхь: перхать храпеть
ааезпртхь: заперхать захрапеть
адитчь: дичать чадить
аадзитчь: задичать зачадить
абилотчь: облачить обличать
адилоптчь: подличать подчалить
аилстчь: сличать счалить
аилоттчь: отличать отчалить
адимнотчь: модничать надмочить
аимнтучь: намучить умничать
аилнстчья: лясничать начислять
азитучь: заучить изучать
азилтучь: залучить излучать
атчья: чаять ячать
аагилпртшь: приглашать шпаргалить
аавезртшь: завершать развешать
аилтшь: лишать шалить
авеопрстщь: воспрещать просвещать
бгелотуь: голубеть обуглеть
веелть: велеть леветь
веелопть: повелеть полеветь
веисть: весить висеть сиветь
веиопсть: повесить повисеть посиветь
вееилоптшь: оплешиветь пошевелить
веопсть: воспеть повесть псоветь
дееопрть: допереть поредеть
вдеиопрть: повредить провидеть
деиопрсть: посердить просидеть
деопрть: допреть продеть
дерть: дерть рдеть
вдееортть: довертеть отвердеть
вдееопртть: подвертеть потвердеть
езлть: злеть лезть
еилмть: мелить милеть
беилопрть: приболеть пробелить
еилстть: истлеть стелить
емсть: месть сметь
авеенртть: навертеть травенеть
екнпртуь: крепнуть крупнеть
екноппртуь: покрупнеть попрекнуть
денртуь: дернуть дурнеть
денопртуь: подернуть подурнеть
енопрстья: опреснять прояснеть
емнттуь: метнуть мутнеть
еикпрсть: скрепить скрипеть
еоппрть: попреть пропеть
дееопртть: дотерпеть подтереть
еепрстть: пестреть стерпеть
еоптть: отпеть потеть
еопттуь: отупеть употеть
георть: гореть огреть
бгеоорть: обгореть обогреть
гдеоопрть: подгореть подогреть
георсть: горесть сгореть согреть
геоортть: отгореть отогреть
ееопртть: отпереть потереть
веертть: вертеть ветреть втереть
еиртхь: херить хиреть
еопрсть: проесть сопреть
бвееортть: обвертеть обветреть
есть: есть сеть
авезисть: завесить зависеть
веееипрсть: перевесить перевисеть
веиопрсть: провесить провисеть
етчь: течь четь
адирть: дарить драить
абилость: обсалить ослабить
абинть: банить набить
абгирть: багрить грабить
аабгинрть: набагрить награбить
абгиорть: обагрить ограбить
абгирсть: сбагрить сграбить
билостть: сболтить столбить
бдиоопсть: подсобить сподобить
бзилооть: обозлить озлобить
биопть: обпить побить
бгиорть: горбить гробить
бгиортуь: огрубить угробить
бдиорть: бодрить бродить добрить дробить
абдинорть: бондарить надробить
абдзиоррть: раздобрить раздробить
бдзииорть: избродить издробить
бдиоопрть: побродить подробить
бикоорсть: оскорбить скоробить
биопрть: побрить пробить
бдитуь: будить дубить
бдиопртуь: подрубить пробудить продубить
бгилотуь: голубить обуглить
биртуь: бурить рубить
абинртуь: набурить нарубить
бгиртуь: бугрить грубить
абзирртуь: разбурить разрубить
бдиортуь: дорубить обдурить удобрить
биопрртуь: пробурить прорубить
биорттуь: отбурить отрубить
бвиртуыь: выбурить вырубить
бзитыь: зыбить избыть
авдиипрть: привадить придавить
авдисть: всадить сдавить
авдиотть: отвадить отдавить
авипрсть: вспарить справить
авиопртть: отправить потравить
аавзиртть: затаврить затравить
авиоопсстть: сиповатость сопоставить
взитуья: увязить уязвить
вдиоть: водить двоить довить
взиилоть: изволить изловить
вилотуь: уволить уловить
виопть: вопить повить
виноорть: воронить норовить
авзитья: заявить изваять
вдиртыья: вырядить дырявить
аадилнсть: насладить сандалить
адилотть: отдалить отладить
адилтуь: удалить уладить
деилопсть: подселить последить
дееиопрть: опередить передоить
вдееиопрть: переводить передвоить
авдзиорть: разводить раздвоить
ввдзиоть: взводить вздвоить
вдиость: сводить сдвоить
вдиотуь: уводить удвоить
дилмооть: доломить молодить
дилоость: досолить солодить
дилопть: плодить подлить
бдееиопррть: перебродить передобрить
бдиорсть: сбродить сдобрить
адикнопртуь: напрокудить поднакурить
дипртуь: прудить пудрить
адзипртуь: запрудить запудрить
адинпртуь: напрудить напудрить
дееиппрртуь: перепрудить перепудрить
диосттуь: остудить отсудить
диопсттуь: допустить подустить постудить
диопрсттуь: подтрусить простудить
диоптучь: подучить почудить
ежинть: женить нежить
аежзинрть: разженить разнежить
ежинопть: поженить понежить
джилооть: доложить одолжить
жиоорстть: острожить сторожить
жилстуь: сжулить служить
жисттуья: сутяжить тужиться
азипть: запить пазить
авззиорть: возразить развозить
езиимрть: измерить ремизить
взиноть: вонзить звонить
взиоопть: возопить повозить
ажзиилть: зажилить изжалить
аиилпрсть: присалить распилить
деилмопть: подмелить помедлить
бдеилоть: добелить обделить
беилопть: облепить побелить
деилопть: долепить поделить
аеилрссть: расселить слесарить
еилсттуь: улестить устелить
зилоть: золить озлить
зилмооть: измолоть мозолить
зилоотть: золотить отзолить
илмоть: ломить молить
илмость: милость сломить смолить
илмоотть: молотить отломить отмолить
вилмотыь: выломить вымолить
илопть: плоить полить
илость: слоить солить
дилоопсть: подслоить подсолить
ееилопрсть: переслоить пересолить
илоопрсть: прослоить просолить
илотухь: охулить ухолить
еилптть: петлить теплить
еилоптть: отеплить отлепить
иилстчь: сличить числить
илмстыь: мыслить смылить
азилптуь: залупить запулить
илооптшь: опошлить полошить
вилтья: вилять влиять вялить
авзилтья: завилять завялить извалять
вилоптья: повилять повлиять повялить
илпстья: ляпсить спялить
илмоопрть: примолоть проломить
импртья: примять прямить
агилноопрть: горлопанить погорланить
адимнртуь: дурманить намудрить
аимнттуь: намутить туманить
аинрсттуь: натрусить устранить
аинортхь: наохрить охранить
веикнорть: вкоренить кровенить
иинопрсть: приносить просинить
азилность: залоснить заслонить
инопстуь: осипнуть супонить
биноорть: боронить обронить
илнопттуь: отлипнуть уплотнить
иноттучь: утончить уточнить
диоопть: допоить подоить
иопть: опить поить
иооптть: отопить отпоить
икорть: корить кроить
икоопрть: окропить покорить покроить
иорсть: росить сорить сроить
иортть: торить троить
иорстть: острить строить
азиорстть: заострить застроить
аинорстть: наострить настроить
биоорстть: обострить обстроить отбросить
виорстть: вострить встроить створить
диоопрстть: подострить подстроить
иоопрстть: опростить отпросить поострить построить стопорить
иорттуь: уторить утроить
илопстть: сплотить столпить
икоопсть: оскопить покосить
иопртть: портить тропить
иоптть: отпить топить
иооппртть: попортить протопить
иопттуь: отупить утопить
икопттуь: откупить покутить
ипсттуь: пустить ступить
азипсттуь: запустить заступить
аинпсттуь: напустить наступить
випсттуь: впустить вступить
диоппсттуь: подпустить подступить
ееиппрсттуь: перепустить переступить
ииппрсттуь: припустить приступить
иоппсттуь: попустить поступить
иоппрсттуь: пропустить проступить
иопстттуь: отпустить отступить
ипсттууь: упустить уступить
випсттуыь: выпустить выступить
аиопртшь: ошпарить пошарить
бееиопррсть: перебросить посеребрить
бдиоорть: ободрить одобрить
еикорстть: костерить окрестить
виорсть: ворсить сворить
виортть: вторить творить
веиопрртть: претворить проветрить
виоортть: воротить отворить
вииоопрртть: приворотить приотворить
виоорстть: своротить сотворить
икортуь: окурить укорить
иоопрттшь: потрошить штопорить
иопрсть: просить спорить
азиопрсть: запросить заспорить
ееиоппррсть: перепросить переспорить
иоопрсть: испороть опросить оспорить
диоопрсть: допросить доспорить подсорить
иооппрсть: попросить поспорить
виопрстыь: выпросить выспорить
иопртшь: прошить шпорить
иорссть: сирость ссорить
икртушь: крушить шкурить
зиинртуь: изнурить изринуть
авиксть: ваксить квасить
аавикнсть: наваксить наквасить
авдикопсть: подваксить подквасить
аикорстть: открасить сократить
веиостть: осветить отвесить
гинстуь: гнусить сгинуть
ирсттуь: струить трусить
иопрсттуь: потрусить упростить
ааинрттть: натратить тарантить
веиопстть: повестить посветить
веиопрстть: воспретить просветить
биклооотть: обколотить облокотить
икорттуь: окрутить укротить
аирттфь: трафить фартить
аиопрттфь: потрафить пофартить
авзиорстть: возрастить развитость
веимосстть: светимость совместить
ииосттчь: источить очистить
икопрттуь: покрутить прокутить
иттушь: тушить шутить
иопттушь: потушить пошутить
иопртучь: поручить проучить упрочить
иорсттчь: отстричь строчить
иоттучь: отучить уточить
еипртчь: перчить притечь
итшь: тишь шить
азитшь: затишь зашить
веиопртшь: повершить провешить
еиртшь: ершить решить
лопть: плоть полть
лмооть: ломоть молоть
лоопсть: полость сполоть
рстыь: срыть сырть
естчь: стечь честь
иорсстчь: росчисть состричь
влноооссть: волосность слоновость
кнооссть: косность носкость
илостхь: лихость хилость
аежимнооррсстть: нерасторжимость старорежимность
анопсттуь: отпаснуть путаность
венорсть: верность ревность
вденорсть: вредность древность
бвноорстыь: выборность обрывность
ееллмннооопрсстшыь: лесопромышленность солепромышленность
енноопрсттья: неопрятность потерянность
нооопрстчь: порочность чопорность
ноопрстуь: понурость упорность
аазклностуьь: казуальность каузальность
корстыь: корысть сокрыть
викнтуь: вкинуть кивнуть
глнтуья: глянуть лягнуть
гинпрстуья: пригнуться присягнуть
гнопстуья: погнуться посягнуть
икнтуь: икнуть кинуть
икнстуь: киснуть скинуть
азкмнортуь: размокнуть разомкнуть
кмнооттуь: отмокнуть отомкнуть
кмностуь: смокнуть сомкнуть
кмнтууья: мяукнуть умякнуть
лнооопстуь: ополоснуть полосонуть
елнпстуь: плеснуть слепнуть
елнопстуь: оплеснуть ослепнуть
кнттууь: кутнуть тукнуть уткнуть
анптухь: пахнуть хапнуть
лнптухью: плюхнуть хлюпнуть
ноопсттуыь: опостынуть поостынуть
нопрттуья: отпрянуть протянуть
анрсттуья: растянуть устранять
кнсттууь: стукнуть тускнуть
нстууь: сунуть уснуть
нрсттуухь: струхнуть хрустнуть
нрсттухья: стряхнуть хрястнуть
оопсттыь: опостыть поостыть
алтья: лаять талья
алоптья: опалять полаять
аамнтья: манатья намаять
асттья: статья стаять
аисттья: истаять таиться
авезртья: заверять развеять
веопртья: поверять провеять
вестья: всеять свеять
деостья: досеять одеться содеять
абезлтья: забелять заблеять
иопстья: опиться посиять
авлопстья: влопаться воспалять
бдлоопстья: подсоблять сподоблять
еилстцья: исцелять целиться
иилсстчья: исчислять числиться
вноопртья: поровнять провонять
денрстуья: дернуться усреднять
еикнорстья: искоренять корениться
бвинотья: ботвинья обвинять
илнопстья: исполнять полниться
азнстья: заснять знаться
нстуьяя: уняться уяснять
кортуья: рукоять укорять
ееопрсттья: отпереться перестоять потереться
аипрстья: испарять париться
авопрстья: воспарять порваться
бдоортья: ободрять одобрять
бдортуья: обдурять удобрять
еопртья: оперять отрепья
ерттья: терять третья
викорстыья: выкроиться исковырять
дестья: десять деться
елопчь: оплечь полечь
еоптчь: отпечь потечь
гдеилоопя: логопедия педология
геилноорфя: нефрология френология
агилооптя: логопатия патология
агиилоооппстхя: патопсихология психопатология
аггилоорфя: голография графология
аиилнтя: инталия литания
иимнооптя: монотипия топонимия
аиимннотя: антимония антиномия антонимия
гееимортя: геометрия геотермия
езиимортя: изометрия изотермия
ееиклморрттэя: электрометрия электротермия
бииноря: бриония робиния
агдеииопрртя: гидротерапия дагерротипия
агееилоорттффя: телефотография фототелеграфия
ааавгдииоорртфя: авторадиография радиоавтография
агимноорфя: монография номография
аавииктця: активация кавитация
ааииикртфця: ратификация тарификация
аклря: краля ракля
клпуя: купля пукля
азмня: знамя мазня
вемря: время ревмя
екнорсття: стрекотня трескотня
абнрыя: барыня рабыня
абеклостья: колебаться облекаться
аавдопрстья: оправдаться продаваться
аавденстья: наведаться надеваться
аавдезрстья: разведаться раздеваться
авдзостья: воздаться дозваться
ааавдзирстья: задраиваться раздаиваться
аавилопрсстья: просаливаться прослаиваться
абвдиопстья: подбавиться подбиваться
аабвзирстья: разбавиться разбиваться
абвзиистья: избавиться избиваться
абвиипрстья: прибавиться прибиваться
абвдиостья: добавиться добиваться
абвисстья: сбавиться сбиваться
абвистуья: убавиться убиваться
аввдиостья: дивоваться довиваться
аабвикорстшья: обкрашиваться обшаркиваться
ааавикррсстшья: раскрашиваться расшаркиваться
аавиикрсстшья: искрашиваться исшаркиваться
аавзилстья: завалиться заливаться
ааавзилмсстья: замасливаться засмаливаться
аавееилмпрсстья: перемасливаться пересмаливаться
аавилмопрсстья: промасливаться просмаливаться
аавилнстья: навалиться наливаться
ааавзилморстчья: размолачиваться размочаливаться
аавзиилмостчья: измолачиваться измочаливаться
абвилостья: обвалиться обливаться
аввилстья: ввалиться вливаться
авдилопстья: подвалиться подливаться
авееилпрстья: перевалиться переливаться
аавзилрстья: развалиться разливаться
авиилпрстья: привалиться приливаться
авдилостья: довалиться доливаться
авилопстья: повалиться поливаться
авилопрстья: провалиться проливаться
авилсстья: свалиться славиться сливаться
авилосттья: отвалиться отливаться
аввилстыья: вывалиться выливаться
авдиопстья: допиваться повадиться повидаться подавиться
авиоппрстья: поправиться пропиваться
авипсстья: вписаться спиваться
аавдиорсттья: датироваться отдариваться
абвиорстья: обвариться обриваться
аабвиклоостчья: обколачиваться облокачиваться
аабвиоорстчья: оборачиваться орабочиваться
аавзикрстучья: закручиваться закурчавиться
авгоорссттья: восторгаться сторговаться
аавкорсстья: красоваться расковаться
аавзрстья: завраться зарваться
аавнрстья: навраться нарваться
авдорстья: довраться дорваться
аавзоррстья: разовраться разорваться
авзиорстья: изовраться изорваться
авопррстья: провраться прорваться
авоорсттья: отовраться оторваться
авврстыья: врываться вырваться
аавзксстыья: высказаться сказываться
аавеелмпрстыья: переламываться перемалываться
ааавзлмрстыья: разламываться размалываться
аавзилмстыья: изламываться измалываться
аавлмсстыья: сламываться смалываться
ааввлмстыыья: выламываться вымалываться
авмосттыья: вымотаться отмываться
аавкопсттыья: откапываться покатываться
авеклпсстыья: выплескаться склепываться
авеипрсстчыья: исчерпываться причесываться
авзирстыья: выразиться изрываться
авкрсстыья: выкрасться скрываться
аавипрссстыья: присасываться расписываться
абгиорссттья: обстригаться сгорбатиться
агиорссттья: исторгаться остригаться
агзилостья: заголиться изолгаться
агдопрстыья: допрыгаться подыграться
абдостья: бодаться обдаться
аадзрстья: задраться раздаться
авдистья: видаться давиться
авдистуья: увидаться удавиться
адопрстья: подраться продаться
аежлстья: желаться лежаться
аажзрстья: зажраться разжаться
аазкопстья: закопаться показаться
азилстья: залиться лизаться
аазилнстья: налазиться нализаться
авгзрстыья: вгрызаться взыграться
абзостьяя: забояться обязаться
аекрссттья: стрекаться трескаться
абекорссттья: обстрекаться обтрескаться
аакссттья: скататься таскаться
аеклпсстья: плескаться склепаться
аикссттья: скатиться скитаться тискаться
ааикнссттья: наскитаться натискаться
авикссттья: втискаться сквитаться
аикопрссттья: проскитаться протискаться
авксттыья: втыкаться выткаться
аксттуья: кутаться тукаться
аазимнстья: заминаться заниматься
аазимнопстья: запоминаться позаниматься
абимностья: обминаться обниматься
аазимнрстья: разминаться разниматься
аиимнпрстья: приминаться приниматься
аимнсстья: сминаться сниматься
аимнстуья: уминаться униматься
абжиностья: обжинаться обнажиться
аинпстья: напиться пинаться
аеипрсстчья: исчерпаться причесаться
алпстхьюя: плюхаться хлюпаться
апрссттьяя: спрятаться стряпаться
аборсстья: бросаться собраться
агдиорстья: доиграться оградиться
адзиорстья: задориться зародиться изодраться раздоиться
абдиорстья: добираться обдираться
аавзирстья: завариться завираться
аавзиррстья: развариться развираться
авдиорстья: довариться довираться
авиопррстья: провариться провираться
авиорсттья: отвариться отвираться отравиться
аадзирстья: задираться задраиться
адиорсттья: отдариться отдираться
аажинрстья: нажариться нажираться
абжиорстья: обжариться обжираться
ажиопррстья: прожариться прожираться
азиорстья: зароиться озариться озираться
аазипрстья: запариться запираться
аиоппррстья: пропариться пропираться
аипрсстья: спариться спираться
аиопрсттья: отпариться отпираться
аипрстуья: упариться упираться
абиорсттья: обратиться обтираться
авирсттья: втираться травиться
аирссттья: стариться стираться
аиопрссттья: постираться растопиться
аиорсссттья: состариться состираться
арстучья: ручаться чураться
аазрстучья: заручаться зачураться
аеоссттчья: отчесаться сочетаться
авиксттья: вкатиться квитаться
азимосттья: затомиться измотаться
аопстттуья: отпутаться утоптаться
аарсссттья: расстаться срастаться
абеорсттхья: обтерхаться отбрехаться
аилосттчья: отличаться отчалиться
авеосстщья: освещаться совещаться
авеопрсстщья: воспрещаться просвещаться
адезрстья: зардеться раздеться
еепрссттья: пестреться стерпеться
агезоррстья: разгореться разогреться
веерсттья: вертеться втереться
веиопрсстья: провеситься провисеться
веиоссттья: осветиться отвисеться
абилосстья: обсалиться ослабиться
бзилоостья: обозлиться озлобиться
бгиорстья: горбиться гробиться
бдиорстья: бодриться добриться дробиться
абдзиоррстья: раздобриться раздробиться
бикоорсстья: оскорбиться скоробиться
биопрстья: побриться пробиться
абзирстуья: забуриться зарубиться
бзистыья: зыбиться избыться
авдиопрстья: подвариться продавиться
авиопрстья: оправиться повариться
вдиостья: водиться двоиться довиться
адилстуья: удалиться уладиться
авдзиостья: заводиться задвоиться
авдзиорстья: разводиться раздвоиться
вдиосстья: сводиться сдвоиться
дилопстья: плодиться подлиться
адзипрстуья: запрудиться запудриться
диопстучья: подучиться почудиться
бжиостья: божиться обжиться
бжиоопстья: побожиться пообжиться
ежинстья: жениться нежиться
аежимнстья: жеманиться манежиться
аежимнопстья: пожеманиться поманежиться
аежзинрстья: разжениться разнежиться
ежинопстья: пожениться понежиться
джилоостья: доложиться одолжиться
азиопрстья: позариться поразиться
взиностья: вонзиться звониться
еилопсстья: ослепиться поселиться
илмостья: ломиться молиться
илмоосттья: отломиться отмолиться
вилмостыья: выломиться вымолиться
илоопрсстья: прослоиться просолиться
илоопстшья: опошлиться полошиться
авзилстьяя: завялиться изваляться
импрстуьяя: приумяться упрямиться
аинрссттуья: натруситься устраниться
взиноосстья: возноситься созвониться
азилносстья: залосниться заслониться
иносттучья: утончиться уточниться
азиорссттья: заостриться застроиться
биоорссттья: обостриться обстроиться
иоопрссттья: опроститься отпроситься построиться стопориться
илопссттья: сплотиться столпиться
икоопрстья: окропиться покориться
иопсттья: отпиться топиться
иооппрсттья: попортиться протопиться
иопссттья: поститься стопиться
ииппрссттуья: припуститься приступиться
иопссттуья: опуститься оступиться
аипрсссттуья: распуститься расступиться
веиопррсттья: претвориться проветриться
виоорсттья: воротиться отвориться
виоорссттья: своротиться сотвориться
иопрсстья: проситься спориться
азиопрсстья: запроситься заспориться
аинопрсстья: напроситься наспориться
диоопрсстья: допроситься доспориться
иклоосстья: исколоться колоситься
биклооосттья: обколотиться облокотиться
икорсттуья: окрутиться укротиться
ииоссттчья: источиться очиститься
икопрсттуья: покрутиться прокутиться
иосттучья: отучиться очутиться уточиться
аирссттушья: расшутиться устрашиться
иопрстучья: поручиться проучиться упрочиться
азирстучья: заручиться разучиться
еирстшья: ершиться решиться
клопсстьяя: поклясться скопляться
икнстуья: икнуться кинуться
азикнстуья: заикнуться закинуться
кнсттууья: тукнуться уткнуться
лнпстухьюя: плюхнуться хлюпнуться
нрссттухьяя: стряхнуться хрястнуться
анрссттуьяя: растянуться устраняться
алопстьяя: опаляться полаяться
авлопрстьяя: оправляться проваляться
